g g g g g g g g g g g g g g g
g g g g g r r r g g g g g g g
g g R1 g g r C1 r g g P1 g g g g
g g g g g r r r g g g g g g g
g g g g g g g r g g g g g g g
g g g g g g g r g g g g g g g
g g g g g g g r g g g g g g g
g r r r r r r r r r r r r r g
g g g g g g g r g g g g g g g
g g g g g g g r g g g g g g g
g g g g g g g r g g g g g g g
g g g g g g g r g g g g g g g
g g g g g g g r g g g g g g g
g g g g g g g r g g g g g g g
g g g g g g g g g g g g g g g